"a" = (/turf,/area)
"b" = (/obj/Tree,/turf,/area)

(1,1,1) = {"
aaaaaaaaaaaaaaaaaaaaaaaaaaaaaaaaaaaaaaaaaaaaaababa
bababababababababababababababababababababababababa
bababababababababababababababababababababababababa
bababababababababababababababababababababababababa
bababababababababababababababababababababababbbbbb
babababaaaaaaaaaaaaaaaaaaaaaaaaaaaaaaaaaaaaaababab
babababaaaaaaaaaaaaaaaaaaaaaaaaaaaaaaaaaaaaaabbbbb
babababaaaaaaaaaaaaaaaaaaaaaaaaaaaaaaaaaaaaaababab
babababaaaaaaaaaaaaaaaaaaaaaaaaaaaaaaaaaaaaaabbbbb
babababaaaaaaaaaaaaaaaaaaaaaaaaaaaaaaaaaaaaaababab
babababaaaaaaaaaaaaaaaaaaaaaaaaaaaaaaaaaaaaaabbbbb
babababaaaaaaaaaaaaaaaaaaaaaaaaaaaaaaaaaaaaaababab
babababaaaaaaaaaaaaaaaaaaaaaaaaaaaaaaaaaaaaaabbbbb
babababaaaaaaaaaaaaaaaaaaaaaaaaaaaaaaaaaaaaaababab
babababaaaaaaaaaaaaaaaaaaaaaaaaaaaaaaaaaaaaaabbbbb
babababaaaaaaaaaaaaaaaaaaaaaaaaaaaaaaaaaaaaaababab
babababaaaaaaaaaaaaaaaaaaaaaaaaaaaaaaaaaaaaaabbbbb
babababaaaaaaaaaaaaaaaaaaaaaaaaaaaaaaaaaaaaaababab
babababaaaaaaaaaaaaaaaaaaaaaaaaaaaaaaaaaaaaaabbbbb
babababaaaaaaaaaaaaaaaaaaaaaaaaaaaaaaaaaaaaaababab
babababaaaaaaaaaaaaaaaaaaaaaaaaaaaaaaaaaaaaaabbbbb
babababaaaaaaaaaaaaaaaaaaaaaaaaaaaaaaaaaaaaaababab
babababaaaaaaaaaaaaaaaaaaaaaaaaaaaaaaaaaaaaaabbbbb
babababaaaaaaaaaaaaaaaaaaaaaaaaaaaaaaaaaaaaaababab
babababaaaaaaaaaaaaaaaaaaaaaaaaaaaaaaaaaaaaaabbbbb
babababaaaaaaaaaaaaaaaaaaaaaaaaaaaaaaaaaaaaaababab
babababaaaaaaaaaaaaaaaaaaaaaaaaaaaaaaaaaaaaaabbbbb
babababaaaaaaaaaaaaaaaaaaaaaaaaaaaaaaaaaaaaaababab
babababaaaaaaaaaaaaaaaaaaaaaaaaaaaaaaaaaaaaaabbbbb
babababaaaaaaaaaaaaaaaaaaaaaaaaaaaaaaaaaaaaaababab
babababaaaaaaaaaaaaaaaaaaaaaaaaaaaaaaaaaaaaaabbbbb
babababaaaaaaaaaaaaaaaaaaaaaaaaaaaaaaaaaaaaaababab
babababaaaaaaaaaaaaaaaaaaaaaaaaaaaaaaaaaaaaaabbbbb
babababaaaaaaaaaaaaaaaaaaaaaaaaaaaaaaaaaaaaaababab
babababaaaaaaaaaaaaaaaaaaaaaaaaaaaaaaaaaaaaaabbbbb
babababaaaaaaaaaaaaaaaaaaaaaaaaaaaaaaaaaaaaaababab
babababaaaaaaaaaaaaaaaaaaaaaaaaaaaaaaaaaaaaaabbbbb
babababaaaaaaaaaaaaaaaaaaaaaaaaaaaaaaaaaaaaaababab
babababaaaaaaaaaaaaaaaaaaaaaaaaaaaaaaaaaaaaaabbbbb
babababaaaaaaaaaaaaaaaaaaaaaaaaaaaaaaaaaaaaaababab
babababaaaaaaaaaaaaaaaaaaaaaaaaaaaaaaaaaaaaaabbbbb
bbbbbbbbbbabababababababababababababababababababab
aaaaaaaaaaaaaaaaaaaaaaaaaaaaaaaaaaaaaaaaaaaaabbbbb
bbbbbbbbbbabababababababababababababababababababab
aabbbaaaaaaaaaaaaaaaaaaaaaaaaaaaaaaaaaaaaaaaaababa
bbbbbbbbbbabababababababababababababababababababab
aaaaabaaaaaaaaaaaaaaaaaaaaaaaaaaaaaaaaaaaaaaaaaaaa
bbbbbbbbbbabababababababababababababababababababab
aaaaaaabbaaaaaaaaaaaaaaaaaaaaaaaaaaaaaaaaaaaaaaaaa
bbbbbbbbbbabababababababababababababababababababab
"}
